1 13 31
###############################
#p  *  s* *  1 *   *  * * *   #
# # # #*# # #*#*# # # #*#*#*# #
#  f*     b**  *      *   * * #
#f# # # # #*# # #*#*# # # # #*#
#          x **  *  *1        #
# # # # # # # # # #*# #*# # # #
#*  b      *  *      *        #
# # # # #*# # # #*#*# # # # # #
#*    **  *       *           #
# #*# # # # # # #*# # # # # # #
#a          *   *  *          #
###############################