5 13 31
###############################
#p          *  ** * *    f    #
# # # # #*# # #*# # # # # #*# #
#    * * **4  **  #   *    ** #
# #*# # # #3# # #*#1# # # # #*#
#    b     *     **      *  **#
# # #*# 1 # # # #*#*#*#*# # # #
#   *        *   * *x* *   5  #
# # # # #*# # # # # # #*# #*# #
#   **2*         *2           #
# # # # # # # # # #*# # # # #*#
#a ** **  *  5                #
###############################
