4 13 31
###############################
#p          *  ** * *   s     #
# # # # #*# # #*# # # # # #*# #
#    * * **1  **  #   *    ** #
# #*# # # #4# # #*#1# # # # #*#
#    b     *     **      *  **#
# # #*# 3 # # # #*#*#*#*# # # #
#   *        *   * *x* *   2  #
# # # # #*# # # # # # #*# #*# #
#   **2*         *3           #
# # # # # # # # # #*# # # # #*#
#a**5 **  *  4                #
###############################