3 13 31
###############################
#p * *3       *  ** * *      *#
# # # # #*# # #*# # # # # #*# #
#   f* * *** **  #   *    **  #
# #*# # # # #4# #b#1# # # # #*#
#   *      *     **      *  **#
# # #*# 3 # # # #*#*#*#*# # # #
#   *        *   * *x* *   4  #
# # # # #*#4# # # # # #*# #*# #
#   ***3         *2           #
# # # # # # # # # #*# # # # #*#
#a**  **  *    5              #
###############################
