2 13 31
###############################
#p * *2       *  ** * *      *#
# # # # #b# # #*# # # # # #*# #
#    * * *** **      *    **  #
# #*# # # # #1# #b#1# # # # #*#
#          *     **      *  **#
# # #*# #s# # # #*#*#*#*# # # #
#   *        *   * *x* *      #
# #*# # #*# # # # # # #*# #*# #
#   * *f         *1           #
# # # # # # # # # #*# # # # #*#
#a  * *   *    3              #
###############################

