6 13 31
###############################
#p      2  *  ** * *    f     #
# # # # #*# # #*# # # # # #*# #
#    * * **4  **  #   *  3 ** #
# #*# # # #3# # #*#1# # # # #*#
#    b     *     **      *  **#
# # #*# 5 # # # #*#*#*#*# # # #
#   *        *   * *x* *   1  #
# # # # #*# # # # # # #*# #*# #
#   **2*         *4           #
# # # # # # # # # #*# # # # #*#
#a**3 **  *  5                #
###############################
